AD: ar='أندورا' de='Andorra' en='Andorra' es='Andorra' fr='Andorre' it='Andorra' ja='アンドラ' pl='Andora' ru='Андорра' tr='Andorra' zh='安道尔'
AE: ar='الإمارات العربية المتحدة' de='Vereinigte Arabische Emirate' en='United Arab Emirates' es='Emiratos Árabes Unidos' fr='Émirats arabes unis' it='Emirati Arabi Uniti' ja='アラブ首長国連邦' pl='Zjednoczone Emiraty Arabskie' ru='ОАЭ' tr='Birleşik Arap Emirlikleri' zh='阿拉伯联合酋长国'
AF: ar='أفغانستان' de='Afghanistan' en='Afghanistan' es='Afganistán' fr='Afghanistan' it='Afghanistan' ja='アフガニスタン' pl='Afganistan' ru='Афганистан' tr='Afganistan' zh='阿富汗'
AG: ar='أنتيغوا وبربودا' de='Antigua und Barbuda' en='Antigua and Barbuda' es='Antigua y Barbuda' fr='Antigua-et-Barbuda' it='Antigua e Barbuda' ja='アンティグア・バーブーダ' pl='Antigua i Barbuda' ru='Антигуа и Барбуда' tr='Antigua ve Barbuda' zh='安提瓜和巴布达'
AI: ar='أنغويلا' de='Anguilla' en='Anguilla' es='Anguila' fr='Anguilla' it='Anguilla' ja='アンギラ' pl='Anguilla' ru='Ангилья' tr='Anguilla' zh='安圭拉'
AL: ar='ألبانيا' de='Albanien' en='Albania' es='Albania' fr='Albanie' it='Albania' ja='アルバニア' pl='Albania' ru='Албания' tr='Arnavutluk' zh='阿尔巴尼亚'
AM: ar='أرمينيا' de='Armenien' en='Armenia' es='Armenia' fr='Arménie' it='Armenia' ja='アルメニア' pl='Armenia' ru='Армения' tr='Ermenistan' zh='亚美尼亚'
AO: ar='أنغولا' de='Angola' en='Angola' es='Angola' fr='Angola' it='Angola' ja='アンゴラ' pl='Angola' ru='Ангола' tr='Angola' zh='安哥拉'
AQ: ar='أنتاركتيكا' de='Antarktis' en='Antarctica' es='Antártida' fr='Antarctique' it='Antartide' ja='南極' pl='Antarktyda' ru='Антарктида' tr='Antarktika' zh='南极洲'
AR: ar='الأرجنتين' de='Argentinien' en='Argentina' es='Argentina' fr='Argentine' it='Argentina' ja='アルゼンチン' pl='Argentyna' ru='Аргентина' tr='Arjantin' zh='阿根廷'
AS: ar='ساموا الأمريكية' de='Amerikanisch-Samoa' en='American Samoa' es='Samoa Americana' fr='Samoa américaines' it='Samoa Americane' ja='米領サモア' pl='Samoa Amerykańskie' ru='Американское Самоа' tr='Amerikan Samoası' zh='美属萨摩亚'
AT: ar='النمسا' de='Österreich' en='Austria' es='Austria' fr='Autriche' it='Austria' ja='オーストリア' pl='Austria' ru='Австрия' tr='Avusturya' zh='奥地利'
AU: ar='أستراليا' de='Australien' en='Australia' es='Australia' fr='Australie' it='Australia' ja='オーストラリア' pl='Australia' ru='Австралия' tr='Avustralya' zh='澳大利亚'
AW: ar='أروبا' de='Aruba' en='Aruba' es='Aruba' fr='Aruba' it='Aruba' ja='アルバ' pl='Aruba' ru='Аруба' tr='Aruba' zh='阿鲁巴'
AX: ar='جزر آلاند' de='Ålandinseln' en='Åland Islands' es='Islas Aland' fr='Îles Åland' it='Isole Åland' ja='オーランド諸島' pl='Wyspy Alandzkie' ru='Аландские о-ва' tr='Åland Adaları' zh='奥兰群岛'
AZ: ar='أذربيجان' de='Aserbaidschan' en='Azerbaijan' es='Azerbaiyán' fr='Azerbaïdjan' it='Azerbaigian' ja='アゼルバイジャン' pl='Azerbejdżan' ru='Азербайджан' tr='Azerbaycan' zh='阿塞拜疆'
BA: ar='البوسنة والهرسك' de='Bosnien und Herzegowina' en='Bosnia and Herzegovina' es='Bosnia y Herzegovina' fr='Bosnie-Herzégovine' it='Bosnia ed Erzegovina' ja='ボスニア・ヘルツェゴビナ' pl='Bośnia i Hercegowina' ru='Босния и Герцеговина' tr='Bosna-Hersek' zh='波斯尼亚和黑塞哥维那'
BB: ar='بربادوس' de='Barbados' en='Barbados' es='Barbados' fr='Barbade' it='Barbados' ja='バルバドス' pl='Barbados' ru='Барбадос' tr='Barbados' zh='巴巴多斯'
BD: ar='بنغلاديش' de='Bangladesch' en='Bangladesh' es='Bangladés' fr='Bangladesh' it='Bangladesh' ja='バングラデシュ' pl='Bangladesz' ru='Бангладеш' tr='Bangladeş' zh='孟加拉国'
BE: ar='بلجيكا' de='Belgien' en='Belgium' es='Bélgica' fr='Belgique' it='Belgio' ja='ベルギー' pl='Belgia' ru='Бельгия' tr='Belçika' zh='比利时'
BF: ar='بوركينا فاسو' de='Burkina Faso' en='Burkina Faso' es='Burkina Faso' fr='Burkina Faso' it='Burkina Faso' ja='ブルキナファソ' pl='Burkina Faso' ru='Буркина-Фасо' tr='Burkina Faso' zh='布基纳法索'
BG: ar='بلغاريا' de='Bulgarien' en='Bulgaria' es='Bulgaria' fr='Bulgarie' it='Bulgaria' ja='ブルガリア' pl='Bułgaria' ru='Болгария' tr='Bulgaristan' zh='保加利亚'
BH: ar='البحرين' de='Bahrain' en='Bahrain' es='Baréin' fr='Bahreïn' it='Bahrein' ja='バーレーン' pl='Bahrajn' ru='Бахрейн' tr='Bahreyn' zh='巴林'
BI: ar='بوروندي' de='Burundi' en='Burundi' es='Burundi' fr='Burundi' it='Burundi' ja='ブルンジ' pl='Burundi' ru='Бурунди' tr='Burundi' zh='布隆迪'
BJ: ar='بنين' de='Benin' en='Benin' es='Benín' fr='Bénin' it='Benin' ja='ベナン' pl='Benin' ru='Бенин' tr='Benin' zh='贝宁'
BL: ar='سان بارتليمي' de='St. Barthélemy' en='Saint Barthélemy' es='San Bartolomé' fr='Saint-Barthélemy' it='Saint-Barthélemy' ja='サン・バルテルミー' pl='Saint-Barthélemy' ru='Сен-Бартелеми' tr='Saint Barthelemy' zh='圣巴泰勒米'
BM: ar='برمودا' de='Bermuda' en='Bermuda' es='Bermudas' fr='Bermudes' it='Bermuda' ja='バミューダ' pl='Bermudy' ru='Бермудские о-ва' tr='Bermuda' zh='百慕大'
BN: ar='بروناي' de='Brunei Darussalam' en='Brunei Darussalam' es='Brunéi' fr='Brunei' it='Brunei' ja='ブルネイ' pl='Brunei' ru='Бруней' tr='Brunei' zh='文莱'
BO: ar='بوليفيا' de='Bolivien' en='Bolivia, Plurinational State of' es='Bolivia' fr='Bolivie' it='Bolivia' ja='ボリビア' pl='Boliwia' ru='Боливия' tr='Bolivya' zh='玻利维亚'
BQ: ar='هولندا الكاريبية' de='Karibische Niederlande' en='Bonaire, Sint Eustatius and Saba' es='Caribe neerlandés' fr='Pays-Bas caribéens' it='Caraibi Olandesi' ja='オランダ領カリブ' pl='Niderlandy Karaibskie' ru='Бонэйр, Синт-Эстатиус и Саба' tr='Karayip Hollandası' zh='荷属加勒比区'
BR: ar='البرازيل' de='Brasilien' en='Brazil' es='Brasil' fr='Brésil' it='Brasile' ja='ブラジル' pl='Brazylia' ru='Бразилия' tr='Brezilya' zh='巴西'
BS: ar='جزر البهاما' de='Bahamas' en='Bahamas' es='Bahamas' fr='Bahamas' it='Bahamas' ja='バハマ' pl='Bahamy' ru='Багамы' tr='Bahamalar' zh='巴哈马'
BT: ar='بوتان' de='Bhutan' en='Bhutan' es='Bután' fr='Bhoutan' it='Bhutan' ja='ブータン' pl='Bhutan' ru='Бутан' tr='Butan' zh='不丹'
BV: ar='جزيرة بوفيه' de='Bouvetinsel' en='Bouvet Island' es='Isla Bouvet' fr='Île Bouvet' it='Isola Bouvet' ja='ブーベ島' pl='Wyspa Bouveta' ru='о-в Буве' tr='Bouvet Adası' zh='布韦岛'
BW: ar='بوتسوانا' de='Botsuana' en='Botswana' es='Botsuana' fr='Botswana' it='Botswana' ja='ボツワナ' pl='Botswana' ru='Ботсвана' tr='Botsvana' zh='博茨瓦纳'
BY: ar='بيلاروس' de='Belarus' en='Belarus' es='Bielorrusia' fr='Biélorussie' it='Bielorussia' ja='ベラルーシ' pl='Białoruś' ru='Беларусь' tr='Belarus' zh='白俄罗斯'
BZ: ar='بليز' de='Belize' en='Belize' es='Belice' fr='Belize' it='Belize' ja='ベリーズ' pl='Belize' ru='Белиз' tr='Belize' zh='伯利兹'
CA: ar='كندا' de='Kanada' en='Canada' es='Canadá' fr='Canada' it='Canada' ja='カナダ' pl='Kanada' ru='Канада' tr='Kanada' zh='加拿大'
CC: ar='جزر كوكوس (كيلينغ)' de='Kokosinseln' en='Cocos (Keeling) Islands' es='Islas Cocos' fr='Îles Cocos' it='Isole Cocos (Keeling)' ja='ココス(キーリング)諸島' pl='Wyspy Kokosowe' ru='Кокосовые о-ва' tr='Cocos (Keeling) Adaları' zh='科科斯（基林）群岛'
CD: ar='الكونغو - كينشاسا' de='Kongo-Kinshasa' en='Congo, The Democratic Republic of the' es='República Democrática del Congo' fr='Congo-Kinshasa' it='Congo - Kinshasa' ja='コンゴ民主共和国(キンシャサ)' pl='Demokratyczna Republika Konga' ru='Конго - Киншаса' tr='Kongo - Kinşasa' zh='刚果（金）'
CF: ar='جمهورية أفريقيا الوسطى' de='Zentralafrikanische Republik' en='Central African Republic' es='República Centroafricana' fr='République centrafricaine' it='Repubblica Centrafricana' ja='中央アフリカ共和国' pl='Republika Środkowoafrykańska' ru='Центрально-Африканская Республика' tr='Orta Afrika Cumhuriyeti' zh='中非共和国'
CG: ar='الكونغو - برازافيل' de='Kongo-Brazzaville' en='Congo' es='Congo' fr='Congo-Brazzaville' it='Congo-Brazzaville' ja='コンゴ共和国(ブラザビル)' pl='Kongo' ru='Конго - Браззавиль' tr='Kongo - Brazavil' zh='刚果（布）'
CH: ar='سويسرا' de='Schweiz' en='Switzerland' es='Suiza' fr='Suisse' it='Svizzera' ja='スイス' pl='Szwajcaria' ru='Швейцария' tr='İsviçre' zh='瑞士'
CI: ar='ساحل العاج' de='Côte d’Ivoire' en='Côte d'Ivoire' es='Côte d’Ivoire' fr='Côte d’Ivoire' it='Costa d’Avorio' ja='コートジボワール' pl='Côte d’Ivoire' ru='Кот-д’Ивуар' tr='Côte d’Ivoire' zh='科特迪瓦'
CK: ar='جزر كوك' de='Cookinseln' en='Cook Islands' es='Islas Cook' fr='Îles Cook' it='Isole Cook' ja='クック諸島' pl='Wyspy Cooka' ru='о-ва Кука' tr='Cook Adaları' zh='库克群岛'
CL: ar='تشيلي' de='Chile' en='Chile' es='Chile' fr='Chili' it='Cile' ja='チリ' pl='Chile' ru='Чили' tr='Şili' zh='智利'
CM: ar='الكاميرون' de='Kamerun' en='Cameroon' es='Camerún' fr='Cameroun' it='Camerun' ja='カメルーン' pl='Kamerun' ru='Камерун' tr='Kamerun' zh='喀麦隆'
CN: ar='الصين' de='China' en='China' es='China' fr='Chine' it='Cina' ja='中国' pl='Chiny' ru='Китай' tr='Çin' zh='中国'
CO: ar='كولومبيا' de='Kolumbien' en='Colombia' es='Colombia' fr='Colombie' it='Colombia' ja='コロンビア' pl='Kolumbia' ru='Колумбия' tr='Kolombiya' zh='哥伦比亚'
CR: ar='كوستاريكا' de='Costa Rica' en='Costa Rica' es='Costa Rica' fr='Costa Rica' it='Costa Rica' ja='コスタリカ' pl='Kostaryka' ru='Коста-Рика' tr='Kosta Rika' zh='哥斯达黎加'
CU: ar='كوبا' de='Kuba' en='Cuba' es='Cuba' fr='Cuba' it='Cuba' ja='キューバ' pl='Kuba' ru='Куба' tr='Küba' zh='古巴'
CV: ar='الرأس الأخضر' de='Cabo Verde' en='Cabo Verde' es='Cabo Verde' fr='Cap-Vert' it='Capo Verde' ja='カーボベルデ' pl='Republika Zielonego Przylądka' ru='Кабо-Верде' tr='Cabo Verde' zh='佛得角'
CW: ar='كوراساو' de='Curaçao' en='Curaçao' es='Curazao' fr='Curaçao' it='Curaçao' ja='キュラソー' pl='Curaçao' ru='Кюрасао' tr='Curaçao' zh='库拉索'
CX: ar='جزيرة كريسماس' de='Weihnachtsinsel' en='Christmas Island' es='Isla de Navidad' fr='Île Christmas' it='Isola Christmas' ja='クリスマス島' pl='Wyspa Bożego Narodzenia' ru='о-в Рождества' tr='Christmas Adası' zh='圣诞岛'
CY: ar='قبرص' de='Zypern' en='Cyprus' es='Chipre' fr='Chypre' it='Cipro' ja='キプロス' pl='Cypr' ru='Кипр' tr='Kıbrıs' zh='塞浦路斯'
CZ: ar='التشيك' de='Tschechien' en='Czechia' es='Chequia' fr='Tchéquie' it='Cechia' ja='チェコ' pl='Czechy' ru='Чехия' tr='Çekya' zh='捷克'
DE: ar='ألمانيا' de='Deutschland' en='Germany' es='Alemania' fr='Allemagne' it='Germania' ja='ドイツ' pl='Niemcy' ru='Германия' tr='Almanya' zh='德国'
DJ: ar='جيبوتي' de='Dschibuti' en='Djibouti' es='Yibuti' fr='Djibouti' it='Gibuti' ja='ジブチ' pl='Dżibuti' ru='Джибути' tr='Cibuti' zh='吉布提'
DK: ar='الدانمرك' de='Dänemark' en='Denmark' es='Dinamarca' fr='Danemark' it='Danimarca' ja='デンマーク' pl='Dania' ru='Дания' tr='Danimarka' zh='丹麦'
DM: ar='دومينيكا' de='Dominica' en='Dominica' es='Dominica' fr='Dominique' it='Dominica' ja='ドミニカ国' pl='Dominika' ru='Доминика' tr='Dominika' zh='多米尼克'
DO: ar='جمهورية الدومينيكان' de='Dominikanische Republik' en='Dominican Republic' es='República Dominicana' fr='République dominicaine' it='Repubblica Dominicana' ja='ドミニカ共和国' pl='Dominikana' ru='Доминиканская Республика' tr='Dominik Cumhuriyeti' zh='多米尼加共和国'
DZ: ar='الجزائر' de='Algerien' en='Algeria' es='Argelia' fr='Algérie' it='Algeria' ja='アルジェリア' pl='Algieria' ru='Алжир' tr='Cezayir' zh='阿尔及利亚'
EC: ar='الإكوادور' de='Ecuador' en='Ecuador' es='Ecuador' fr='Équateur' it='Ecuador' ja='エクアドル' pl='Ekwador' ru='Эквадор' tr='Ekvador' zh='厄瓜多尔'
EE: ar='إستونيا' de='Estland' en='Estonia' es='Estonia' fr='Estonie' it='Estonia' ja='エストニア' pl='Estonia' ru='Эстония' tr='Estonya' zh='爱沙尼亚'
EG: ar='مصر' de='Ägypten' en='Egypt' es='Egipto' fr='Égypte' it='Egitto' ja='エジプト' pl='Egipt' ru='Египет' tr='Mısır' zh='埃及'
EH: ar='الصحراء الغربية' de='Westsahara' en='Western Sahara' es='Sáhara Occidental' fr='Sahara occidental' it='Sahara Occidentale' ja='西サハラ' pl='Sahara Zachodnia' ru='Западная Сахара' tr='Batı Sahra' zh='西撒哈拉'
ER: ar='إريتريا' de='Eritrea' en='Eritrea' es='Eritrea' fr='Érythrée' it='Eritrea' ja='エリトリア' pl='Erytrea' ru='Эритрея' tr='Eritre' zh='厄立特里亚'
ES: ar='إسبانيا' de='Spanien' en='Spain' es='España' fr='Espagne' it='Spagna' ja='スペイン' pl='Hiszpania' ru='Испания' tr='İspanya' zh='西班牙'
ET: ar='إثيوبيا' de='Äthiopien' en='Ethiopia' es='Etiopía' fr='Éthiopie' it='Etiopia' ja='エチオピア' pl='Etiopia' ru='Эфиопия' tr='Etiyopya' zh='埃塞俄比亚'
FI: ar='فنلندا' de='Finnland' en='Finland' es='Finlandia' fr='Finlande' it='Finlandia' ja='フィンランド' pl='Finlandia' ru='Финляндия' tr='Finlandiya' zh='芬兰'
FJ: ar='فيجي' de='Fidschi' en='Fiji' es='Fiyi' fr='Fidji' it='Figi' ja='フィジー' pl='Fidżi' ru='Фиджи' tr='Fiji' zh='斐济'
FK: ar='جزر فوكلاند' de='Falklandinseln' en='Falkland Islands (Malvinas)' es='Islas Malvinas' fr='Îles Malouines' it='Isole Falkland' ja='フォークランド諸島' pl='Falklandy' ru='Фолклендские о-ва' tr='Falkland Adaları' zh='福克兰群岛'
FM: ar='ميكرونيزيا' de='Mikronesien' en='Micronesia, Federated States of' es='Micronesia' fr='Micronésie' it='Micronesia' ja='ミクロネシア連邦' pl='Mikronezja' ru='Федеративные Штаты Микронезии' tr='Mikronezya' zh='密克罗尼西亚'
FO: ar='جزر فارو' de='Färöer' en='Faroe Islands' es='Islas Feroe' fr='Îles Féroé' it='Isole Fær Øer' ja='フェロー諸島' pl='Wyspy Owcze' ru='Фарерские о-ва' tr='Faroe Adaları' zh='法罗群岛'
FR: ar='فرنسا' de='Frankreich' en='France' es='Francia' fr='France' it='Francia' ja='フランス' pl='Francja' ru='Франция' tr='Fransa' zh='法国'
GA: ar='الغابون' de='Gabun' en='Gabon' es='Gabón' fr='Gabon' it='Gabon' ja='ガボン' pl='Gabon' ru='Габон' tr='Gabon' zh='加蓬'
GB: ar='المملكة المتحدة' de='Vereinigtes Königreich' en='United Kingdom' es='Reino Unido' fr='Royaume-Uni' it='Regno Unito' ja='イギリス' pl='Wielka Brytania' ru='Великобритания' tr='Birleşik Krallık' zh='英国'
GD: ar='غرينادا' de='Grenada' en='Grenada' es='Granada' fr='Grenade' it='Grenada' ja='グレナダ' pl='Grenada' ru='Гренада' tr='Grenada' zh='格林纳达'
GE: ar='جورجيا' de='Georgien' en='Georgia' es='Georgia' fr='Géorgie' it='Georgia' ja='ジョージア' pl='Gruzja' ru='Грузия' tr='Gürcistan' zh='格鲁吉亚'
GF: ar='غويانا الفرنسية' de='Französisch-Guayana' en='French Guiana' es='Guayana Francesa' fr='Guyane française' it='Guyana Francese' ja='仏領ギアナ' pl='Gujana Francuska' ru='Французская Гвиана' tr='Fransız Guyanası' zh='法属圭亚那'
GG: ar='غيرنزي' de='Guernsey' en='Guernsey' es='Guernesey' fr='Guernesey' it='Guernsey' ja='ガーンジー' pl='Guernsey' ru='Гернси' tr='Guernsey' zh='根西岛'
GH: ar='غانا' de='Ghana' en='Ghana' es='Ghana' fr='Ghana' it='Ghana' ja='ガーナ' pl='Ghana' ru='Гана' tr='Gana' zh='加纳'
GI: ar='جبل طارق' de='Gibraltar' en='Gibraltar' es='Gibraltar' fr='Gibraltar' it='Gibilterra' ja='ジブラルタル' pl='Gibraltar' ru='Гибралтар' tr='Cebelitarık' zh='直布罗陀'
GL: ar='غرينلاند' de='Grönland' en='Greenland' es='Groenlandia' fr='Groenland' it='Groenlandia' ja='グリーンランド' pl='Grenlandia' ru='Гренландия' tr='Grönland' zh='格陵兰'
GM: ar='غامبيا' de='Gambia' en='Gambia' es='Gambia' fr='Gambie' it='Gambia' ja='ガンビア' pl='Gambia' ru='Гамбия' tr='Gambiya' zh='冈比亚'
GN: ar='غينيا' de='Guinea' en='Guinea' es='Guinea' fr='Guinée' it='Guinea' ja='ギニア' pl='Gwinea' ru='Гвинея' tr='Gine' zh='几内亚'
GP: ar='غوادلوب' de='Guadeloupe' en='Guadeloupe' es='Guadalupe' fr='Guadeloupe' it='Guadalupa' ja='グアドループ' pl='Gwadelupa' ru='Гваделупа' tr='Guadeloupe' zh='瓜德罗普'
GQ: ar='غينيا الاستوائية' de='Äquatorialguinea' en='Equatorial Guinea' es='Guinea Ecuatorial' fr='Guinée équatoriale' it='Guinea Equatoriale' ja='赤道ギニア' pl='Gwinea Równikowa' ru='Экваториальная Гвинея' tr='Ekvator Ginesi' zh='赤道几内亚'
GR: ar='اليونان' de='Griechenland' en='Greece' es='Grecia' fr='Grèce' it='Grecia' ja='ギリシャ' pl='Grecja' ru='Греция' tr='Yunanistan' zh='希腊'
GS: ar='جورجيا الجنوبية وجزر ساندويتش الجنوبية' de='Südgeorgien und die Südlichen Sandwichinseln' en='South Georgia and the South Sandwich Islands' es='Islas Georgia del Sur y Sandwich del Sur' fr='Géorgie du Sud-et-les Îles Sandwich du Sud' it='Georgia del Sud e Sandwich Australi' ja='サウスジョージア・サウスサンドウィッチ諸島' pl='Georgia Południowa i Sandwich Południowy' ru='Южная Георгия и Южные Сандвичевы о-ва' tr='Güney Georgia ve Güney Sandwich Adaları' zh='南乔治亚和南桑威奇群岛'
GT: ar='غواتيمالا' de='Guatemala' en='Guatemala' es='Guatemala' fr='Guatemala' it='Guatemala' ja='グアテマラ' pl='Gwatemala' ru='Гватемала' tr='Guatemala' zh='危地马拉'
GU: ar='غوام' de='Guam' en='Guam' es='Guam' fr='Guam' it='Guam' ja='グアム' pl='Guam' ru='Гуам' tr='Guam' zh='关岛'
GW: ar='غينيا بيساو' de='Guinea-Bissau' en='Guinea-Bissau' es='Guinea-Bisáu' fr='Guinée-Bissau' it='Guinea-Bissau' ja='ギニアビサウ' pl='Gwinea Bissau' ru='Гвинея-Бисау' tr='Gine-Bissau' zh='几内亚比绍'
GY: ar='غيانا' de='Guyana' en='Guyana' es='Guyana' fr='Guyana' it='Guyana' ja='ガイアナ' pl='Gujana' ru='Гайана' tr='Guyana' zh='圭亚那'
HK: ar='هونغ كونغ الصينية (منطقة إدارية خاصة)' de='Sonderverwaltungsregion Hongkong' en='Hong Kong' es='RAE de Hong Kong (China)' fr='R.A.S. chinoise de Hong Kong' it='RAS di Hong Kong' ja='中華人民共和国香港特別行政区' pl='SRA Hongkong (Chiny)' ru='Гонконг (САР)' tr='Çin Hong Kong ÖİB' zh='中国香港特别行政区'
HM: ar='جزيرة هيرد وجزر ماكدونالد' de='Heard und McDonaldinseln' en='Heard Island and McDonald Islands' es='Islas Heard y McDonald' fr='Îles Heard-et-MacDonald' it='Isole Heard e McDonald' ja='ハード島・マクドナルド諸島' pl='Wyspy Heard i McDonalda' ru='о-ва Херд и Макдональд' tr='Heard Adası ve McDonald Adaları' zh='赫德岛和麦克唐纳群岛'
HN: ar='هندوراس' de='Honduras' en='Honduras' es='Honduras' fr='Honduras' it='Honduras' ja='ホンジュラス' pl='Honduras' ru='Гондурас' tr='Honduras' zh='洪都拉斯'
HR: ar='كرواتيا' de='Kroatien' en='Croatia' es='Croacia' fr='Croatie' it='Croazia' ja='クロアチア' pl='Chorwacja' ru='Хорватия' tr='Hırvatistan' zh='克罗地亚'
HT: ar='هايتي' de='Haiti' en='Haiti' es='Haití' fr='Haïti' it='Haiti' ja='ハイチ' pl='Haiti' ru='Гаити' tr='Haiti' zh='海地'
HU: ar='هنغاريا' de='Ungarn' en='Hungary' es='Hungría' fr='Hongrie' it='Ungheria' ja='ハンガリー' pl='Węgry' ru='Венгрия' tr='Macaristan' zh='匈牙利'
ID: ar='إندونيسيا' de='Indonesien' en='Indonesia' es='Indonesia' fr='Indonésie' it='Indonesia' ja='インドネシア' pl='Indonezja' ru='Индонезия' tr='Endonezya' zh='印度尼西亚'
IE: ar='أيرلندا' de='Irland' en='Ireland' es='Irlanda' fr='Irlande' it='Irlanda' ja='アイルランド' pl='Irlandia' ru='Ирландия' tr='İrlanda' zh='爱尔兰'
IL: ar='إسرائيل' de='Israel' en='Israel' es='Israel' fr='Israël' it='Israele' ja='イスラエル' pl='Izrael' ru='Израиль' tr='İsrail' zh='以色列'
IM: ar='جزيرة مان' de='Isle of Man' en='Isle of Man' es='Isla de Man' fr='Île de Man' it='Isola di Man' ja='マン島' pl='Wyspa Man' ru='о-в Мэн' tr='Man Adası' zh='马恩岛'
IN: ar='الهند' de='Indien' en='India' es='India' fr='Inde' it='India' ja='インド' pl='Indie' ru='Индия' tr='Hindistan' zh='印度'
IO: ar='الإقليم البريطاني في المحيط الهندي' de='Britisches Territorium im Indischen Ozean' en='British Indian Ocean Territory' es='Territorio Británico del Océano Índico' fr='Territoire britannique de l’océan Indien' it='Territorio Britannico dell’Oceano Indiano' ja='英領インド洋地域' pl='Brytyjskie Terytorium Oceanu Indyjskiego' ru='Британская территория в Индийском океане' tr='Britanya Hint Okyanusu Toprakları' zh='英属印度洋领地'
IQ: ar='العراق' de='Irak' en='Iraq' es='Irak' fr='Irak' it='Iraq' ja='イラク' pl='Irak' ru='Ирак' tr='Irak' zh='伊拉克'
IR: ar='إيران' de='Iran' en='Iran, Islamic Republic of' es='Irán' fr='Iran' it='Iran' ja='イラン' pl='Iran' ru='Иран' tr='İran' zh='伊朗'
IS: ar='آيسلندا' de='Island' en='Iceland' es='Islandia' fr='Islande' it='Islanda' ja='アイスランド' pl='Islandia' ru='Исландия' tr='İzlanda' zh='冰岛'
IT: ar='إيطاليا' de='Italien' en='Italy' es='Italia' fr='Italie' it='Italia' ja='イタリア' pl='Włochy' ru='Италия' tr='İtalya' zh='意大利'
JE: ar='جيرسي' de='Jersey' en='Jersey' es='Jersey' fr='Jersey' it='Jersey' ja='ジャージー' pl='Jersey' ru='Джерси' tr='Jersey' zh='泽西岛'
JM: ar='جامايكا' de='Jamaika' en='Jamaica' es='Jamaica' fr='Jamaïque' it='Giamaica' ja='ジャマイカ' pl='Jamajka' ru='Ямайка' tr='Jamaika' zh='牙买加'
JO: ar='الأردن' de='Jordanien' en='Jordan' es='Jordania' fr='Jordanie' it='Giordania' ja='ヨルダン' pl='Jordania' ru='Иордания' tr='Ürdün' zh='约旦'
JP: ar='اليابان' de='Japan' en='Japan' es='Japón' fr='Japon' it='Giappone' ja='日本' pl='Japonia' ru='Япония' tr='Japonya' zh='日本'
KE: ar='كينيا' de='Kenia' en='Kenya' es='Kenia' fr='Kenya' it='Kenya' ja='ケニア' pl='Kenia' ru='Кения' tr='Kenya' zh='肯尼亚'
KG: ar='قيرغيزستان' de='Kirgisistan' en='Kyrgyzstan' es='Kirguistán' fr='Kirghizstan' it='Kirghizistan' ja='キルギス' pl='Kirgistan' ru='Киргизия' tr='Kırgızistan' zh='吉尔吉斯斯坦'
KH: ar='كمبوديا' de='Kambodscha' en='Cambodia' es='Camboya' fr='Cambodge' it='Cambogia' ja='カンボジア' pl='Kambodża' ru='Камбоджа' tr='Kamboçya' zh='柬埔寨'
KI: ar='كيريباتي' de='Kiribati' en='Kiribati' es='Kiribati' fr='Kiribati' it='Kiribati' ja='キリバス' pl='Kiribati' ru='Кирибати' tr='Kiribati' zh='基里巴斯'
KM: ar='جزر القمر' de='Komoren' en='Comoros' es='Comoras' fr='Comores' it='Comore' ja='コモロ' pl='Komory' ru='Коморы' tr='Komorlar' zh='科摩罗'
KN: ar='سانت كيتس ونيفيس' de='St. Kitts und Nevis' en='Saint Kitts and Nevis' es='San Cristóbal y Nieves' fr='Saint-Christophe-et-Niévès' it='Saint Kitts e Nevis' ja='セントクリストファー・ネーヴィス' pl='Saint Kitts i Nevis' ru='Сент-Китс и Невис' tr='Saint Kitts ve Nevis' zh='圣基茨和尼维斯'
KP: ar='كوريا الشمالية' de='Nordkorea' en='Korea, Democratic People's Republic of' es='Corea del Norte' fr='Corée du Nord' it='Corea del Nord' ja='北朝鮮' pl='Korea Północna' ru='КНДР' tr='Kuzey Kore' zh='朝鲜'
KR: ar='كوريا الجنوبية' de='Südkorea' en='Korea, Republic of' es='Corea del Sur' fr='Corée du Sud' it='Corea del Sud' ja='韓国' pl='Korea Południowa' ru='Республика Корея' tr='Güney Kore' zh='韩国'
KW: ar='الكويت' de='Kuwait' en='Kuwait' es='Kuwait' fr='Koweït' it='Kuwait' ja='クウェート' pl='Kuwejt' ru='Кувейт' tr='Kuveyt' zh='科威特'
KY: ar='جزر كايمان' de='Kaimaninseln' en='Cayman Islands' es='Islas Caimán' fr='Îles Caïmans' it='Isole Cayman' ja='ケイマン諸島' pl='Kajmany' ru='о-ва Кайман' tr='Cayman Adaları' zh='开曼群岛'
KZ: ar='كازاخستان' de='Kasachstan' en='Kazakhstan' es='Kazajistán' fr='Kazakhstan' it='Kazakistan' ja='カザフスタン' pl='Kazachstan' ru='Казахстан' tr='Kazakistan' zh='哈萨克斯坦'
LA: ar='لاوس' de='Laos' en='Lao People's Democratic Republic' es='Laos' fr='Laos' it='Laos' ja='ラオス' pl='Laos' ru='Лаос' tr='Laos' zh='老挝'
LB: ar='لبنان' de='Libanon' en='Lebanon' es='Líbano' fr='Liban' it='Libano' ja='レバノン' pl='Liban' ru='Ливан' tr='Lübnan' zh='黎巴嫩'
LC: ar='سانت لوسيا' de='St. Lucia' en='Saint Lucia' es='Santa Lucía' fr='Sainte-Lucie' it='Saint Lucia' ja='セントルシア' pl='Saint Lucia' ru='Сент-Люсия' tr='Saint Lucia' zh='圣卢西亚'
LI: ar='ليختنشتاين' de='Liechtenstein' en='Liechtenstein' es='Liechtenstein' fr='Liechtenstein' it='Liechtenstein' ja='リヒテンシュタイン' pl='Liechtenstein' ru='Лихтенштейн' tr='Liechtenstein' zh='列支敦士登'
LK: ar='سريلانكا' de='Sri Lanka' en='Sri Lanka' es='Sri Lanka' fr='Sri Lanka' it='Sri Lanka' ja='スリランカ' pl='Sri Lanka' ru='Шри-Ланка' tr='Sri Lanka' zh='斯里兰卡'
LR: ar='ليبيريا' de='Liberia' en='Liberia' es='Liberia' fr='Liberia' it='Liberia' ja='リベリア' pl='Liberia' ru='Либерия' tr='Liberya' zh='利比里亚'
LS: ar='ليسوتو' de='Lesotho' en='Lesotho' es='Lesoto' fr='Lesotho' it='Lesotho' ja='レソト' pl='Lesotho' ru='Лесото' tr='Lesotho' zh='莱索托'
LT: ar='ليتوانيا' de='Litauen' en='Lithuania' es='Lituania' fr='Lituanie' it='Lituania' ja='リトアニア' pl='Litwa' ru='Литва' tr='Litvanya' zh='立陶宛'
LU: ar='لوكسمبورغ' de='Luxemburg' en='Luxembourg' es='Luxemburgo' fr='Luxembourg' it='Lussemburgo' ja='ルクセンブルク' pl='Luksemburg' ru='Люксембург' tr='Lüksemburg' zh='卢森堡'
LV: ar='لاتفيا' de='Lettland' en='Latvia' es='Letonia' fr='Lettonie' it='Lettonia' ja='ラトビア' pl='Łotwa' ru='Латвия' tr='Letonya' zh='拉脱维亚'
LY: ar='ليبيا' de='Libyen' en='Libya' es='Libia' fr='Libye' it='Libia' ja='リビア' pl='Libia' ru='Ливия' tr='Libya' zh='利比亚'
MA: ar='المغرب' de='Marokko' en='Morocco' es='Marruecos' fr='Maroc' it='Marocco' ja='モロッコ' pl='Maroko' ru='Марокко' tr='Fas' zh='摩洛哥'
MC: ar='موناكو' de='Monaco' en='Monaco' es='Mónaco' fr='Monaco' it='Monaco' ja='モナコ' pl='Monako' ru='Монако' tr='Monako' zh='摩纳哥'
MD: ar='مولدوفا' de='Republik Moldau' en='Moldova, Republic of' es='Moldavia' fr='Moldavie' it='Moldavia' ja='モルドバ' pl='Mołdawia' ru='Молдова' tr='Moldova' zh='摩尔多瓦'
ME: ar='الجبل الأسود' de='Montenegro' en='Montenegro' es='Montenegro' fr='Monténégro' it='Montenegro' ja='モンテネグロ' pl='Czarnogóra' ru='Черногория' tr='Karadağ' zh='黑山'
MF: ar='سان مارتن' de='St. Martin' en='Saint Martin (French part)' es='San Martín' fr='Saint-Martin' it='Saint Martin' ja='サン・マルタン' pl='Saint-Martin' ru='Сен-Мартен' tr='Saint Martin' zh='法属圣马丁'
MG: ar='مدغشقر' de='Madagaskar' en='Madagascar' es='Madagascar' fr='Madagascar' it='Madagascar' ja='マダガスカル' pl='Madagaskar' ru='Мадагаскар' tr='Madagaskar' zh='马达加斯加'
MH: ar='جزر مارشال' de='Marshallinseln' en='Marshall Islands' es='Islas Marshall' fr='Îles Marshall' it='Isole Marshall' ja='マーシャル諸島' pl='Wyspy Marshalla' ru='Маршалловы о-ва' tr='Marshall Adaları' zh='马绍尔群岛'
MK: ar='مقدونيا الشمالية' de='Nordmazedonien' en='North Macedonia' es='Macedonia del Norte' fr='Macédoine du Nord' it='Macedonia del Nord' ja='北マケドニア' pl='Macedonia Północna' ru='Северная Македония' tr='Kuzey Makedonya' zh='北马其顿'
ML: ar='مالي' de='Mali' en='Mali' es='Mali' fr='Mali' it='Mali' ja='マリ' pl='Mali' ru='Мали' tr='Mali' zh='马里'
MM: ar='ميانمار (بورما)' de='Myanmar' en='Myanmar' es='Myanmar (Birmania)' fr='Myanmar (Birmanie)' it='Myanmar (Birmania)' ja='ミャンマー (ビルマ)' pl='Mjanma (Birma)' ru='Мьянма (Бирма)' tr='Myanmar (Burma)' zh='缅甸'
MN: ar='منغوليا' de='Mongolei' en='Mongolia' es='Mongolia' fr='Mongolie' it='Mongolia' ja='モンゴル' pl='Mongolia' ru='Монголия' tr='Moğolistan' zh='蒙古'
MO: ar='منطقة ماكاو الإدارية الخاصة' de='Sonderverwaltungsregion Macau' en='Macao' es='RAE de Macao (China)' fr='R.A.S. chinoise de Macao' it='RAS di Macao' ja='中華人民共和国マカオ特別行政区' pl='SRA Makau (Chiny)' ru='Макао (САР)' tr='Çin Makao ÖİB' zh='中国澳门特别行政区'
MP: ar='جزر ماريانا الشمالية' de='Nördliche Marianen' en='Northern Mariana Islands' es='Islas Marianas del Norte' fr='Îles Mariannes du Nord' it='Isole Marianne Settentrionali' ja='北マリアナ諸島' pl='Mariany Północne' ru='Северные Марианские о-ва' tr='Kuzey Mariana Adaları' zh='北马里亚纳群岛'
MQ: ar='جزر المارتينيك' de='Martinique' en='Martinique' es='Martinica' fr='Martinique' it='Martinica' ja='マルティニーク' pl='Martynika' ru='Мартиника' tr='Martinik' zh='马提尼克'
MR: ar='موريتانيا' de='Mauretanien' en='Mauritania' es='Mauritania' fr='Mauritanie' it='Mauritania' ja='モーリタニア' pl='Mauretania' ru='Мавритания' tr='Moritanya' zh='毛里塔尼亚'
MS: ar='مونتسرات' de='Montserrat' en='Montserrat' es='Montserrat' fr='Montserrat' it='Montserrat' ja='モントセラト' pl='Montserrat' ru='Монтсеррат' tr='Montserrat' zh='蒙特塞拉特'
MT: ar='مالطا' de='Malta' en='Malta' es='Malta' fr='Malte' it='Malta' ja='マルタ' pl='Malta' ru='Мальта' tr='Malta' zh='马耳他'
MU: ar='موريشيوس' de='Mauritius' en='Mauritius' es='Mauricio' fr='Maurice' it='Mauritius' ja='モーリシャス' pl='Mauritius' ru='Маврикий' tr='Mauritius' zh='毛里求斯'
MV: ar='جزر المالديف' de='Malediven' en='Maldives' es='Maldivas' fr='Maldives' it='Maldive' ja='モルディブ' pl='Malediwy' ru='Мальдивы' tr='Maldivler' zh='马尔代夫'
MW: ar='ملاوي' de='Malawi' en='Malawi' es='Malaui' fr='Malawi' it='Malawi' ja='マラウイ' pl='Malawi' ru='Малави' tr='Malavi' zh='马拉维'
MX: ar='المكسيك' de='Mexiko' en='Mexico' es='México' fr='Mexique' it='Messico' ja='メキシコ' pl='Meksyk' ru='Мексика' tr='Meksika' zh='墨西哥'
MY: ar='ماليزيا' de='Malaysia' en='Malaysia' es='Malasia' fr='Malaisie' it='Malaysia' ja='マレーシア' pl='Malezja' ru='Малайзия' tr='Malezya' zh='马来西亚'
MZ: ar='موزمبيق' de='Mosambik' en='Mozambique' es='Mozambique' fr='Mozambique' it='Mozambico' ja='モザンビーク' pl='Mozambik' ru='Мозамбик' tr='Mozambik' zh='莫桑比克'
NA: ar='ناميبيا' de='Namibia' en='Namibia' es='Namibia' fr='Namibie' it='Namibia' ja='ナミビア' pl='Namibia' ru='Намибия' tr='Namibya' zh='纳米比亚'
NC: ar='كاليدونيا الجديدة' de='Neukaledonien' en='New Caledonia' es='Nueva Caledonia' fr='Nouvelle-Calédonie' it='Nuova Caledonia' ja='ニューカレドニア' pl='Nowa Kaledonia' ru='Новая Каледония' tr='Yeni Kaledonya' zh='新喀里多尼亚'
NE: ar='النيجر' de='Niger' en='Niger' es='Níger' fr='Niger' it='Niger' ja='ニジェール' pl='Niger' ru='Нигер' tr='Nijer' zh='尼日尔'
NF: ar='جزيرة نورفولك' de='Norfolkinsel' en='Norfolk Island' es='Isla Norfolk' fr='Île Norfolk' it='Isola Norfolk' ja='ノーフォーク島' pl='Norfolk' ru='о-в Норфолк' tr='Norfolk Adası' zh='诺福克岛'
NG: ar='نيجيريا' de='Nigeria' en='Nigeria' es='Nigeria' fr='Nigeria' it='Nigeria' ja='ナイジェリア' pl='Nigeria' ru='Нигерия' tr='Nijerya' zh='尼日利亚'
NI: ar='نيكاراغوا' de='Nicaragua' en='Nicaragua' es='Nicaragua' fr='Nicaragua' it='Nicaragua' ja='ニカラグア' pl='Nikaragua' ru='Никарагуа' tr='Nikaragua' zh='尼加拉瓜'
NL: ar='هولندا' de='Niederlande' en='Netherlands' es='Países Bajos' fr='Pays-Bas' it='Paesi Bassi' ja='オランダ' pl='Holandia' ru='Нидерланды' tr='Hollanda' zh='荷兰'
NO: ar='النرويج' de='Norwegen' en='Norway' es='Noruega' fr='Norvège' it='Norvegia' ja='ノルウェー' pl='Norwegia' ru='Норвегия' tr='Norveç' zh='挪威'
NP: ar='نيبال' de='Nepal' en='Nepal' es='Nepal' fr='Népal' it='Nepal' ja='ネパール' pl='Nepal' ru='Непал' tr='Nepal' zh='尼泊尔'
NR: ar='ناورو' de='Nauru' en='Nauru' es='Nauru' fr='Nauru' it='Nauru' ja='ナウル' pl='Nauru' ru='Науру' tr='Nauru' zh='瑙鲁'
NU: ar='نيوي' de='Niue' en='Niue' es='Niue' fr='Niue' it='Niue' ja='ニウエ' pl='Niue' ru='Ниуэ' tr='Niue' zh='纽埃'
NZ: ar='نيوزيلندا' de='Neuseeland' en='New Zealand' es='Nueva Zelanda' fr='Nouvelle-Zélande' it='Nuova Zelanda' ja='ニュージーランド' pl='Nowa Zelandia' ru='Новая Зеландия' tr='Yeni Zelanda' zh='新西兰'
OM: ar='عُمان' de='Oman' en='Oman' es='Omán' fr='Oman' it='Oman' ja='オマーン' pl='Oman' ru='Оман' tr='Umman' zh='阿曼'
PA: ar='بنما' de='Panama' en='Panama' es='Panamá' fr='Panama' it='Panama' ja='パナマ' pl='Panama' ru='Панама' tr='Panama' zh='巴拿马'
PE: ar='بيرو' de='Peru' en='Peru' es='Perú' fr='Pérou' it='Perù' ja='ペルー' pl='Peru' ru='Перу' tr='Peru' zh='秘鲁'
PF: ar='بولينيزيا الفرنسية' de='Französisch-Polynesien' en='French Polynesia' es='Polinesia Francesa' fr='Polynésie française' it='Polinesia Francese' ja='仏領ポリネシア' pl='Polinezja Francuska' ru='Французская Полинезия' tr='Fransız Polinezyası' zh='法属波利尼西亚'
PG: ar='بابوا غينيا الجديدة' de='Papua-Neuguinea' en='Papua New Guinea' es='Papúa Nueva Guinea' fr='Papouasie-Nouvelle-Guinée' it='Papua Nuova Guinea' ja='パプアニューギニア' pl='Papua-Nowa Gwinea' ru='Папуа — Новая Гвинея' tr='Papua Yeni Gine' zh='巴布亚新几内亚'
PH: ar='الفلبين' de='Philippinen' en='Philippines' es='Filipinas' fr='Philippines' it='Filippine' ja='フィリピン' pl='Filipiny' ru='Филиппины' tr='Filipinler' zh='菲律宾'
PK: ar='باكستان' de='Pakistan' en='Pakistan' es='Pakistán' fr='Pakistan' it='Pakistan' ja='パキスタン' pl='Pakistan' ru='Пакистан' tr='Pakistan' zh='巴基斯坦'
PL: ar='بولندا' de='Polen' en='Poland' es='Polonia' fr='Pologne' it='Polonia' ja='ポーランド' pl='Polska' ru='Польша' tr='Polonya' zh='波兰'
PM: ar='سان بيير ومكويلون' de='St. Pierre und Miquelon' en='Saint Pierre and Miquelon' es='San Pedro y Miquelón' fr='Saint-Pierre-et-Miquelon' it='Saint-Pierre e Miquelon' ja='サンピエール島・ミクロン島' pl='Saint-Pierre i Miquelon' ru='Сен-Пьер и Микелон' tr='Saint Pierre ve Miquelon' zh='圣皮埃尔和密克隆群岛'
PN: ar='جزر بيتكيرن' de='Pitcairninseln' en='Pitcairn' es='Islas Pitcairn' fr='Îles Pitcairn' it='Isole Pitcairn' ja='ピトケアン諸島' pl='Pitcairn' ru='о-ва Питкэрн' tr='Pitcairn Adaları' zh='皮特凯恩群岛'
PR: ar='بورتوريكو' de='Puerto Rico' en='Puerto Rico' es='Puerto Rico' fr='Porto Rico' it='Portorico' ja='プエルトリコ' pl='Portoryko' ru='Пуэрто-Рико' tr='Porto Riko' zh='波多黎各'
PS: ar='الأراضي الفلسطينية' de='Palästinensische Autonomiegebiete' en='Palestine, State of' es='Territorios Palestinos' fr='Territoires palestiniens' it='Territori Palestinesi' ja='パレスチナ自治区' pl='Terytoria Palestyńskie' ru='Палестинские территории' tr='Filistin Bölgeleri' zh='巴勒斯坦领土'
PT: ar='البرتغال' de='Portugal' en='Portugal' es='Portugal' fr='Portugal' it='Portogallo' ja='ポルトガル' pl='Portugalia' ru='Португалия' tr='Portekiz' zh='葡萄牙'
PW: ar='بالاو' de='Palau' en='Palau' es='Palaos' fr='Palaos' it='Palau' ja='パラオ' pl='Palau' ru='Палау' tr='Palau' zh='帕劳'
PY: ar='باراغواي' de='Paraguay' en='Paraguay' es='Paraguay' fr='Paraguay' it='Paraguay' ja='パラグアイ' pl='Paragwaj' ru='Парагвай' tr='Paraguay' zh='巴拉圭'
QA: ar='قطر' de='Katar' en='Qatar' es='Catar' fr='Qatar' it='Qatar' ja='カタール' pl='Katar' ru='Катар' tr='Katar' zh='卡塔尔'
RE: ar='روينيون' de='Réunion' en='Réunion' es='Reunión' fr='La Réunion' it='Riunione' ja='レユニオン' pl='Reunion' ru='Реюньон' tr='Reunion' zh='留尼汪'
RO: ar='رومانيا' de='Rumänien' en='Romania' es='Rumanía' fr='Roumanie' it='Romania' ja='ルーマニア' pl='Rumunia' ru='Румыния' tr='Romanya' zh='罗马尼亚'
RS: ar='صربيا' de='Serbien' en='Serbia' es='Serbia' fr='Serbie' it='Serbia' ja='セルビア' pl='Serbia' ru='Сербия' tr='Sırbistan' zh='塞尔维亚'
RU: ar='روسيا' de='Russland' en='Russian Federation' es='Rusia' fr='Russie' it='Russia' ja='ロシア' pl='Rosja' ru='Россия' tr='Rusya' zh='俄罗斯'
RW: ar='رواندا' de='Ruanda' en='Rwanda' es='Ruanda' fr='Rwanda' it='Ruanda' ja='ルワンダ' pl='Rwanda' ru='Руанда' tr='Ruanda' zh='卢旺达'
SA: ar='المملكة العربية السعودية' de='Saudi-Arabien' en='Saudi Arabia' es='Arabia Saudí' fr='Arabie saoudite' it='Arabia Saudita' ja='サウジアラビア' pl='Arabia Saudyjska' ru='Саудовская Аравия' tr='Suudi Arabistan' zh='沙特阿拉伯'
SB: ar='جزر سليمان' de='Salomonen' en='Solomon Islands' es='Islas Salomón' fr='Îles Salomon' it='Isole Salomone' ja='ソロモン諸島' pl='Wyspy Salomona' ru='Соломоновы о-ва' tr='Solomon Adaları' zh='所罗门群岛'
SC: ar='سيشل' de='Seychellen' en='Seychelles' es='Seychelles' fr='Seychelles' it='Seychelles' ja='セーシェル' pl='Seszele' ru='Сейшельские о-ва' tr='Seyşeller' zh='塞舌尔'
SD: ar='السودان' de='Sudan' en='Sudan' es='Sudán' fr='Soudan' it='Sudan' ja='スーダン' pl='Sudan' ru='Судан' tr='Sudan' zh='苏丹'
SE: ar='السويد' de='Schweden' en='Sweden' es='Suecia' fr='Suède' it='Svezia' ja='スウェーデン' pl='Szwecja' ru='Швеция' tr='İsveç' zh='瑞典'
SG: ar='سنغافورة' de='Singapur' en='Singapore' es='Singapur' fr='Singapour' it='Singapore' ja='シンガポール' pl='Singapur' ru='Сингапур' tr='Singapur' zh='新加坡'
SH: ar='سانت هيلينا' de='St. Helena' en='Saint Helena, Ascension and Tristan da Cunha' es='Santa Elena' fr='Sainte-Hélène' it='Sant’Elena' ja='セントヘレナ' pl='Wyspa Świętej Heleny' ru='о-в Св. Елены' tr='Saint Helena' zh='圣赫勒拿'
SI: ar='سلوفينيا' de='Slowenien' en='Slovenia' es='Eslovenia' fr='Slovénie' it='Slovenia' ja='スロベニア' pl='Słowenia' ru='Словения' tr='Slovenya' zh='斯洛文尼亚'
SJ: ar='سفالبارد وجان ماين' de='Spitzbergen und Jan Mayen' en='Svalbard and Jan Mayen' es='Svalbard y Jan Mayen' fr='Svalbard et Jan Mayen' it='Svalbard e Jan Mayen' ja='スバールバル諸島・ヤンマイエン島' pl='Svalbard i Jan Mayen' ru='Шпицберген и Ян-Майен' tr='Svalbard ve Jan Mayen' zh='斯瓦尔巴和扬马延'
SK: ar='سلوفاكيا' de='Slowakei' en='Slovakia' es='Eslovaquia' fr='Slovaquie' it='Slovacchia' ja='スロバキア' pl='Słowacja' ru='Словакия' tr='Slovakya' zh='斯洛伐克'
SL: ar='سيراليون' de='Sierra Leone' en='Sierra Leone' es='Sierra Leona' fr='Sierra Leone' it='Sierra Leone' ja='シエラレオネ' pl='Sierra Leone' ru='Сьерра-Леоне' tr='Sierra Leone' zh='塞拉利昂'
SM: ar='سان مارينو' de='San Marino' en='San Marino' es='San Marino' fr='Saint-Marin' it='San Marino' ja='サンマリノ' pl='San Marino' ru='Сан-Марино' tr='San Marino' zh='圣马力诺'
SN: ar='السنغال' de='Senegal' en='Senegal' es='Senegal' fr='Sénégal' it='Senegal' ja='セネガル' pl='Senegal' ru='Сенегал' tr='Senegal' zh='塞内加尔'
SO: ar='الصومال' de='Somalia' en='Somalia' es='Somalia' fr='Somalie' it='Somalia' ja='ソマリア' pl='Somalia' ru='Сомали' tr='Somali' zh='索马里'
SR: ar='سورينام' de='Suriname' en='Suriname' es='Surinam' fr='Suriname' it='Suriname' ja='スリナム' pl='Surinam' ru='Суринам' tr='Surinam' zh='苏里南'
SS: ar='جنوب السودان' de='Südsudan' en='South Sudan' es='Sudán del Sur' fr='Soudan du Sud' it='Sud Sudan' ja='南スーダン' pl='Sudan Południowy' ru='Южный Судан' tr='Güney Sudan' zh='南苏丹'
ST: ar='ساو تومي وبرينسيبي' de='São Tomé und Príncipe' en='Sao Tome and Principe' es='Santo Tomé y Príncipe' fr='Sao Tomé-et-Principe' it='São Tomé e Príncipe' ja='サントメ・プリンシペ' pl='Wyspy Świętego Tomasza i Książęca' ru='Сан-Томе и Принсипи' tr='Sao Tome ve Principe' zh='圣多美和普林西比'
SV: ar='السلفادور' de='El Salvador' en='El Salvador' es='El Salvador' fr='Salvador' it='El Salvador' ja='エルサルバドル' pl='Salwador' ru='Сальвадор' tr='El Salvador' zh='萨尔瓦多'
SX: ar='سانت مارتن' de='Sint Maarten' en='Sint Maarten (Dutch part)' es='Sint Maarten' fr='Saint-Martin (partie néerlandaise)' it='Sint Maarten' ja='シント・マールテン' pl='Sint Maarten' ru='Синт-Мартен' tr='Sint Maarten' zh='荷属圣马丁'
SY: ar='سوريا' de='Syrien' en='Syrian Arab Republic' es='Siria' fr='Syrie' it='Siria' ja='シリア' pl='Syria' ru='Сирия' tr='Suriye' zh='叙利亚'
SZ: ar='إسواتيني' de='Eswatini' en='Eswatini' es='Esuatini' fr='Eswatini' it='Eswatini' ja='エスワティニ' pl='Eswatini' ru='Эсватини' tr='Esvatini' zh='斯威士兰'
TC: ar='جزر توركس وكايكوس' de='Turks- und Caicosinseln' en='Turks and Caicos Islands' es='Islas Turcas y Caicos' fr='Îles Turques-et-Caïques' it='Isole Turks e Caicos' ja='タークス・カイコス諸島' pl='Turks i Caicos' ru='Тёркс и Кайкос' tr='Turks ve Caicos Adaları' zh='特克斯和凯科斯群岛'
TD: ar='تشاد' de='Tschad' en='Chad' es='Chad' fr='Tchad' it='Ciad' ja='チャド' pl='Czad' ru='Чад' tr='Çad' zh='乍得'
TF: ar='الأقاليم الجنوبية الفرنسية' de='Französische Süd- und Antarktisgebiete' en='French Southern Territories' es='Territorios Australes Franceses' fr='Terres australes françaises' it='Terre Australi Francesi' ja='仏領極南諸島' pl='Francuskie Terytoria Południowe i Antarktyczne' ru='Французские Южные территории' tr='Fransız Güney Toprakları' zh='法属南部领地'
TG: ar='توغو' de='Togo' en='Togo' es='Togo' fr='Togo' it='Togo' ja='トーゴ' pl='Togo' ru='Того' tr='Togo' zh='多哥'
TH: ar='تايلاند' de='Thailand' en='Thailand' es='Tailandia' fr='Thaïlande' it='Thailandia' ja='タイ' pl='Tajlandia' ru='Таиланд' tr='Tayland' zh='泰国'
TJ: ar='طاجيكستان' de='Tadschikistan' en='Tajikistan' es='Tayikistán' fr='Tadjikistan' it='Tagikistan' ja='タジキスタン' pl='Tadżykistan' ru='Таджикистан' tr='Tacikistan' zh='塔吉克斯坦'
TK: ar='توكيلاو' de='Tokelau' en='Tokelau' es='Tokelau' fr='Tokelau' it='Tokelau' ja='トケラウ' pl='Tokelau' ru='Токелау' tr='Tokelau' zh='托克劳'
TL: ar='تيمور - ليشتي' de='Timor-Leste' en='Timor-Leste' es='Timor-Leste' fr='Timor oriental' it='Timor Est' ja='東ティモール' pl='Timor Wschodni' ru='Восточный Тимор' tr='Timor-Leste' zh='东帝汶'
TM: ar='تركمانستان' de='Turkmenistan' en='Turkmenistan' es='Turkmenistán' fr='Turkménistan' it='Turkmenistan' ja='トルクメニスタン' pl='Turkmenistan' ru='Туркменистан' tr='Türkmenistan' zh='土库曼斯坦'
TN: ar='تونس' de='Tunesien' en='Tunisia' es='Túnez' fr='Tunisie' it='Tunisia' ja='チュニジア' pl='Tunezja' ru='Тунис' tr='Tunus' zh='突尼斯'
TO: ar='تونغا' de='Tonga' en='Tonga' es='Tonga' fr='Tonga' it='Tonga' ja='トンガ' pl='Tonga' ru='Тонга' tr='Tonga' zh='汤加'
TR: ar='تركيا' de='Türkei' en='Turkey' es='Turquía' fr='Turquie' it='Turchia' ja='トルコ' pl='Turcja' ru='Турция' tr='Türkiye' zh='土耳其'
TT: ar='ترينيداد وتوباغو' de='Trinidad und Tobago' en='Trinidad and Tobago' es='Trinidad y Tobago' fr='Trinité-et-Tobago' it='Trinidad e Tobago' ja='トリニダード・トバゴ' pl='Trynidad i Tobago' ru='Тринидад и Тобаго' tr='Trinidad ve Tobago' zh='特立尼达和多巴哥'
TV: ar='توفالو' de='Tuvalu' en='Tuvalu' es='Tuvalu' fr='Tuvalu' it='Tuvalu' ja='ツバル' pl='Tuvalu' ru='Тувалу' tr='Tuvalu' zh='图瓦卢'
TW: ar='تايوان' de='Taiwan' en='Taiwan, Province of China' es='Taiwán' fr='Taïwan' it='Taiwan' ja='台湾' pl='Tajwan' ru='Тайвань' tr='Tayvan' zh='台湾'
TZ: ar='تنزانيا' de='Tansania' en='Tanzania, United Republic of' es='Tanzania' fr='Tanzanie' it='Tanzania' ja='タンザニア' pl='Tanzania' ru='Танзания' tr='Tanzanya' zh='坦桑尼亚'
UA: ar='أوكرانيا' de='Ukraine' en='Ukraine' es='Ucrania' fr='Ukraine' it='Ucraina' ja='ウクライナ' pl='Ukraina' ru='Украина' tr='Ukrayna' zh='乌克兰'
UG: ar='أوغندا' de='Uganda' en='Uganda' es='Uganda' fr='Ouganda' it='Uganda' ja='ウガンダ' pl='Uganda' ru='Уганда' tr='Uganda' zh='乌干达'
UM: ar='جزر الولايات المتحدة النائية' de='Amerikanische Überseeinseln' en='United States Minor Outlying Islands' es='Islas menores alejadas de EE. UU.' fr='Îles mineures éloignées des États-Unis' it='Isole Minori Esterne degli Stati Uniti' ja='合衆国領有小離島' pl='Dalekie Wyspy Mniejsze Stanów Zjednoczonych' ru='Внешние малые о-ва (США)' tr='ABD Küçük Harici Adaları' zh='美国本土外小岛屿'
US: ar='الولايات المتحدة' de='Vereinigte Staaten' en='United States' es='Estados Unidos' fr='États-Unis' it='Stati Uniti' ja='アメリカ合衆国' pl='Stany Zjednoczone' ru='Соединенные Штаты' tr='Amerika Birleşik Devletleri' zh='美国'
UY: ar='أورغواي' de='Uruguay' en='Uruguay' es='Uruguay' fr='Uruguay' it='Uruguay' ja='ウルグアイ' pl='Urugwaj' ru='Уругвай' tr='Uruguay' zh='乌拉圭'
UZ: ar='أوزبكستان' de='Usbekistan' en='Uzbekistan' es='Uzbekistán' fr='Ouzbékistan' it='Uzbekistan' ja='ウズベキスタン' pl='Uzbekistan' ru='Узбекистан' tr='Özbekistan' zh='乌兹别克斯坦'
VA: ar='الفاتيكان' de='Vatikanstadt' en='Holy See (Vatican City State)' es='Ciudad del Vaticano' fr='État de la Cité du Vatican' it='Città del Vaticano' ja='バチカン市国' pl='Watykan' ru='Ватикан' tr='Vatikan' zh='梵蒂冈'
VC: ar='سانت فنسنت وجزر غرينادين' de='St. Vincent und die Grenadinen' en='Saint Vincent and the Grenadines' es='San Vicente y las Granadinas' fr='Saint-Vincent-et-les Grenadines' it='Saint Vincent e Grenadine' ja='セントビンセント及びグレナディーン諸島' pl='Saint Vincent i Grenadyny' ru='Сент-Винсент и Гренадины' tr='Saint Vincent ve Grenadinler' zh='圣文森特和格林纳丁斯'
VE: ar='فنزويلا' de='Venezuela' en='Venezuela, Bolivarian Republic of' es='Venezuela' fr='Venezuela' it='Venezuela' ja='ベネズエラ' pl='Wenezuela' ru='Венесуэла' tr='Venezuela' zh='委内瑞拉'
VG: ar='جزر فيرجن البريطانية' de='Britische Jungferninseln' en='Virgin Islands, British' es='Islas Vírgenes Británicas' fr='Îles Vierges britanniques' it='Isole Vergini Britanniche' ja='英領ヴァージン諸島' pl='Brytyjskie Wyspy Dziewicze' ru='Виргинские о-ва (Великобритания)' tr='Britanya Virjin Adaları' zh='英属维尔京群岛'
VI: ar='جزر فيرجن الأمريكية' de='Amerikanische Jungferninseln' en='Virgin Islands, U.S.' es='Islas Vírgenes de EE. UU.' fr='Îles Vierges des États-Unis' it='Isole Vergini Americane' ja='米領ヴァージン諸島' pl='Wyspy Dziewicze Stanów Zjednoczonych' ru='Виргинские о-ва (США)' tr='ABD Virjin Adaları' zh='美属维尔京群岛'
VN: ar='فيتنام' de='Vietnam' en='Viet Nam' es='Vietnam' fr='Viêt Nam' it='Vietnam' ja='ベトナム' pl='Wietnam' ru='Вьетнам' tr='Vietnam' zh='越南'
VU: ar='فانواتو' de='Vanuatu' en='Vanuatu' es='Vanuatu' fr='Vanuatu' it='Vanuatu' ja='バヌアツ' pl='Vanuatu' ru='Вануату' tr='Vanuatu' zh='瓦努阿图'
WF: ar='جزر والس وفوتونا' de='Wallis und Futuna' en='Wallis and Futuna' es='Wallis y Futuna' fr='Wallis-et-Futuna' it='Wallis e Futuna' ja='ウォリス・フツナ' pl='Wallis i Futuna' ru='Уоллис и Футуна' tr='Wallis ve Futuna' zh='瓦利斯和富图纳'
WS: ar='ساموا' de='Samoa' en='Samoa' es='Samoa' fr='Samoa' it='Samoa' ja='サモア' pl='Samoa' ru='Самоа' tr='Samoa' zh='萨摩亚'
YE: ar='اليمن' de='Jemen' en='Yemen' es='Yemen' fr='Yémen' it='Yemen' ja='イエメン' pl='Jemen' ru='Йемен' tr='Yemen' zh='也门'
YT: ar='مايوت' de='Mayotte' en='Mayotte' es='Mayotte' fr='Mayotte' it='Mayotte' ja='マヨット' pl='Majotta' ru='Майотта' tr='Mayotte' zh='马约特'
ZA: ar='جنوب أفريقيا' de='Südafrika' en='South Africa' es='Sudáfrica' fr='Afrique du Sud' it='Sudafrica' ja='南アフリカ' pl='Republika Południowej Afryki' ru='Южно-Африканская Республика' tr='Güney Afrika' zh='南非'
ZM: ar='زامبيا' de='Sambia' en='Zambia' es='Zambia' fr='Zambie' it='Zambia' ja='ザンビア' pl='Zambia' ru='Замбия' tr='Zambiya' zh='赞比亚'
ZW: ar='زيمبابوي' de='Simbabwe' en='Zimbabwe' es='Zimbabue' fr='Zimbabwe' it='Zimbabwe' ja='ジンバブエ' pl='Zimbabwe' ru='Зимбабве' tr='Zimbabve' zh='津巴布韦'